***XXX****
XX***X*XX*
XXXX***XX*
XXXXXXX***
XX****X*XX
X**XX***XX
X*X**XXXXX
**X*XX***X
*X*****X**
***XXXXXX*